 wwwwwwwwwwwwwwwwwwww
 wDDDDDDDDwwDDDDDDDDw
 wDwwDwwwDwwDwwwDwwDw
 wDDDDDDDDDDDDDDDDDDw
 wDwwDwDwwwwwwDwDwwDw
 wDDDDwDDDwwDDDwDDDDw
 wwwwDwwwDwwDwwwDwwww
 wDDDDDDDDDDDDDDDDDDw
 wDwwDwwwwDDwwwwDwwDw
 wDDwDDDDDDDDDDDDwDDw
 wwDwDwDwwwwwwDwDwDww
 wDDDDwDDDwwDDDwDDDDw
 wDwwwwwwDwwDwwwwwwDw
 wPDDDDDDDDDDDDDDDDDw
 wwwwwwwwwwwwwwwwwwww